111111111111111111111111111111
1P0000000100000000000000000001
101111110101111111111111111101
101000010101000000000000000101
101011010101011111111111110101
10101C01010101C000000000010101
101011110101011111111111010101
100000000101000000000001010101
111111111101111111111101010101
100000000000000000000101010101
101111111111111111110101010101
101C00000000000000010100000101
101111111111111111010111111101
100000000000000000000000000E01
111111111111111111111111111111