1111111111
1000000001
1C001000E1
1000100111
100C10P111
1111111111