111111111111111111111
1P0000000001000000001
101100110001000110001
1011001100000001100C1
100000000010000000001
1000C00001110000C0001
100000000010000000001
101100110000000110001
101100110001000110001
1C00000000010000000E1
111111111111111111111