111111111
100000001
100C00P01
111111111
